111111111111111111111111111
122222222222222222222222221
121111111111121111111111121
121222222222222222222222121
123211211211111112112112321
121211222222222222222112121
121211211111111111112112121
121211212222222222212112121
121211212111121111212112121
121211222122222221222112121
121211211121111121112112121
121222211000000000112222121
121211211011101110112112121
121211211011101110112112121
122211222010000010222112221
121211211011111110112112121
121211211011111110112112121
121222211000050000112222121
121211211121111121112112121
121211222122222221222112121
121211212111121111212112121
121211212222222222212112121
121211211111111111112112121
121211222222222222222112121
123211211211111112112112321
121222222222222222222222121
121111111111121111111111121
122222222222222222222222221
111111111111111111111111111