111111111111111111111111111
122222222222212222222222221
121111211111212111112111121
131111211111212111112111131
121111211111212111112111121
122222222222222222222222221
121111211211111112112111121
121111211211111112112111121
122222211222212222112222221
111111211111010111112111111
111111211111010111112111111
000011211000000000112110000
000011211011101110112110000
000011211011101110112110000
000011200010000010002110000
000011211011111110112110000
000011211011111110112110000
000011211000040000112110000
111111211111010111112111111
111111211111010111112111111
122222211222212222112222221
121111211211111112112111121
121111211211111112112111121
122222222222222222222222221
121111211111212111112111121
131111211111212111112111131
121111211111212111112111121
122222222222212222222222221
111111111111111111111111111