011111111111111111111111110
012222222222222222222222210
012112111111121111111211210
012112111111121111111211210
112112222222222222222211211
112112111111121111111211211
122112222221121122222211221
121111111121121121111111121
122231222222222222222132221
111122211111010111112221111
111121211111010111112121111
000121211000000000112121000
000121211011101110112121000
000121211011101110112121000
000121200010000010002121000
000121211011111110112121000
000121211011111110112121000
000121211000060000112121000
111121211111010111112121111
111122211111010111112221111
122231222222222222222132221
121111111121121121111111121
122112222221121122222211221
112112111111121111111211211
012112222222222222222211210
012112111111121111111211210
012112111111121111111211210
012222222222222222222222210
011111111111111111111111110